#######
#     #
#     #
#     #
#     #
#     #
#   F #
#     #
#     #
#     #
# SH  #
#     #
#######
