###################
#              F  #
#                 #
#                 #
#     SH          #
#                 #
#                 #
#                 #
###################
