###################
#   #          F  #
#   #             #
#          ########
#     SH          #
#                 #
#                 #
#       ####      #
###################
