###############
#  F          #
#             #
#             #
#  SH         #
#             #
#             #
#             #
#             #
#             #
#             #
#             #
#             #
#             #
###############
