###############
#  F          #
#             #
#             #
#  SH         #
#             #
#             #
#             #
#             #
#     #########
#             #
#             #
#             #
#   #         #
###############
